SO bonus/textures/SO_WALL.xpm
WE bonus/textures/WE_WALL.xpm
EA bonus/textures/EA_WALL.xpm
NO bonus/textures/NO_WALL.xpm
C 44,43,66
F 174,219,9

111111111111111111111111111111111111111111111111111111111111111111111111111111
100000000000000000000000000000000000000000000000000000000000000000000000000001
100000000000000000000000000000000000000000000000000000000000000000000000000001
100000000000000000000000000000000000000000000000000000000000000000000000000001
100000000000000000000000000000000000000000000000000000000000000000000000000001
100000000000000000000000000000000000000000000000000000000000000000000000000001
100000000000000000000000000000000000000000000000000000000000000000000000000001
100000000000000000000000000000000000000000000000000000000000000000000000000001
100000000000000000000000000000000000000000000000000000000000000000000000000001
100000000000000000000000000000000000000000000000000000000000000000000000000001
100000000000000000000000000000000000000000000000000000000000000000000000000001
100000000000000000000000000000000000000000000000000000000000000000000000000001
100000000000000000000000000000000111111111111111111111111111111100000000000001
100000000000000000000000000000000100000000000000000000000000000100000000000001
100000000000000000000000000000000100000000000000000000000000000100000000000001
10000000000000000000000000000000010000000000000000000000000000D100000000000001
10000000000000000000000000000000011111111000000111111111111111100000000000001
100000000000000000000000000000000100000010000001000000000000000000000000000001
100000000000000000000000000000000100000010000001000000000000000000000000000001
1000000000000000000000000000000001000000100000010000N0000000000000000000000001
100000000000000000000000000000000100000010000001000000000000000000000000000001
100000000000000000000000000000000100000010000001000000000000000000000000000001
100000000000000000000000000000000111111110000001111111111111111111111111000001
100000000000000000000000000000000100000000000000000000000000000000000001000001
100000000000000000000000000000000100000000000000000000000000000000000001000001
1000000000000000000000000000000001000000000000000000000000000000000000D1000001
100000000000000000000000000000000100000000000000000000000000000000000001000001
100000000000000000000000000000000100000000000000000000000000000000000001000001
100000000000000000000000000000000111111111111110000000111111111111111111000001
100000000000000000000000000000000100000000000010000000100000000000000000000001
100000000000000000000000000000000100000000000010000000100000000000000000000001
10000000000000000000000000000000010000000000001000000D100000000000000000000001
100000000000000000000000000000000100000000000010000000100000000000000000000001
100000000000000000000000000000000100000000000010000000100000000000000000000001
100000000000000000000000000000000111111111111110000000111111111111111111000001
100000000000000000000000000000000100000000000000000000000000000000000001000001
100000000000000000000000000000000100000000000000000000000000000000000001000001
1000000000000000000000000000000001000000000000000000000000000000000000D1000001
100000000000000000000000000000000100000000000000000000000000000000000001000001
100000000000000000000000000000000100000000000000000000000000000000000001000001
100000000000000000000000000000000111111111111111111111111111111111111111000001
100000000000000000000000000000000000000000000000000000000000000000000000000001
100000000000000000000000000000000000000000000000000000000000000000000000000001
100000000000000000000000000000000000000000000000000000000000000000000000000001
100000000000000000000000000000000000000000000000000000000000000000000000000001
100000000000000000000000000000000000000000000000000000000000000000000000000001
100000000000000000000000000000000000000000000000000000000000000000000000000001
100000000000000000000000000000000000000000000000000000000000000000000000000001
100000000000000000000000000000000000000000000000000000000000000000000000000001
111111111111111111111111111111111111111111111111111111111111111111111111111111