SO bonus/textures/SO_WALL.xpm
WE bonus/textures/WE_WALL.xpm
EA bonus/textures/EA_WALL.xpm
NO bonus/textures/NO_WALL.xpm
C 44,43,66
F 32,31,69

11111111111111111111
11000000000000000111
11011111111111000111
11010000000010001111
11010110111111000111
11010110100111000111
11010110101111000011
110101101111 1000011
11010000000011000011
11000000000000000011
11E00000000000000011
11111111111111111111
