SO bonus/textures/SO_WALL.xpm
WE bonus/textures/WE_WALL.xpm
EA bonus/textures/EA_WALL.xpm
NO bonus/textures/NO_WALL.xpm
C 44,43,66
F 32,31,69

1111111111111111111111111111111111
10000000000000000000000000000000W1
1000100000000000000000000000000001
1000100000000000000000000000000001
10001011111111D1111111111111100011
1000100000000000000000000011001111
1000100000000000000000000000110011
1000100000000000000000000011000001
10001111111111111111D1111111111101
1000000000000000000000000000000001
1001111111111110111111111111111101
1000000000000000000000000000000001
11D11111110110101111111111111111D1
1000000001011010000000000000000001
1000111101011110111111111111111111
1000100000000000000000000000000001
1000101011111111111111111111111101
1000100000000000000000000000000001
10001111D1111111111111111111111111
1000000000000000000000000000000011
1111111111111111111111111111111111