SO bonus/textures/lab_wall_dirty.xpm
WE bonus/textures/lab_wall_cracked.xpm
EA bonus/textures/lab_wall_bloody.xpm
NO bonus/textures/lab_wall_vines.xpm

C 2,155,180
F 40,38,35

1111111111111111111111111111111111111111111111111
1000000000000000000000000000010000000000001000001
100000000100000011111111111D11000000000000100S001
1000000001000000100000000000010000000000001000001
1000000001000000100000000000010000000000001000001
1000000001000000100000000000010000000000001111D11
1000000001000000100000000000010000000000000000001
1000000001000000100000000000010000000000000000001
1000000001000000100000000000010000000000000000001
10000000011111111111D111111111000000000000111D111
1000000001000000000000000000010000000000001000001
1000000001000000000000000000010000000000001000001
1000000001000000000000000000010000000000001000001
1000000001000000000000000000010000000000001000001
1000000001000000000000000000010000000000001111111
1000000001000000000000000000010000000000000000001
1000000001111111111111D111111111D111111111D111111
1000000001000000000000000000000000000000000000001
1000000001000000000000000000000000000000000000001
1000000001000000000000000000000000000000000000001
1000000001000000000000000000000000000000000000001
1000000001000000000000000000000000000000000000001
1000000001000000000000000000000000000000000000001
1111D11111111D1111111111D1111111111111111111D1111
1000000000000000000000000000000000000000000000001
1000000000000000000000000000000000000000000000001
1000000000000000000000000000000000000000000000001
1000000000000000000000000000000000000000000000001
100000011111111111111111D111111111111111111111111
1000000100000000000000000000000000000000001000001
1000000100000000000000000000000000000000001000001
1000000100000000000000000000000000000000001000001
1000000100000000000000000000000000000000001000001
1111D11100000000000000000000000000000000001000001
1000000100000000000000000000000000000000001000001
1000000100000000000000000000000000000000001000001
1000000100000000000000000000000000000000001000001
1000000100000000000000000000000000000000001000001
1000000100000000000000000000000000000000001000001
1000000100000000000000000000000000000000001000001
10000001111111111111111111D1111111111111111000001
1000000000000000000000000000000000000000000000001
1000000000000000000000000000000000000000000000001
1000000000000000000000000000000000000000000000001
1000000000000000000000000000000000000000000000001
1000000000000000000000000000000000000000000000001
1111111111111111111111111111111111111111111111111