SO bonus/textures/backrooms1.xpm
WE bonus/textures/backrooms.xpm
EA bonus/textures/backrooms.xpm
NO bonus/textures/backrooms1.xpm

C 130,125,70
F 100,98,63

1111111111111111111111111111111111111111
1100000000011110000000000000111111000011
1101111111011110111111111100111111000011
1101000000000000100000000100000000000011
1101011111111110111111011111111111111011
1101011000000010100000010000000000001011
1101011011111010111111110111111111101011
1101011010000010000000010000000000101011     1111111111111111
1101011010111111111111011111111110101011     10000000P0000001
1101011010100000000000010000000010101011     1000000000000001
1101011010101111111111110111111010101011     1000000000000001
1101011010101000000000010000010010101011     1000000000000001
1101011010101011111111011111011010101011     1000000000000001
1101011010001010000000010000010010101011     1110000000000001
1101011011111010111111011111011010101011     1000000000000001
1101000000000010100000000000010010101011     1111111111111111
1101111111111010111111111111111010101011
1100000000000010000000000000000000101011
1111111111111010111111111111111110101011
1100000000000010000000000000000000100011
1101111111111011111111111111111111111011
11E0000000000000000000000000000000000P11
1111111111111111111111111111111111111111
