SO bonus/textures/SO_WALL.xpm
WE bonus/textures/WE_WALL.xpm
EA bonus/textures/EA_WALL.xpm
NO bonus/textures/NO_WALL.xpm
C 44,43,66
F 32,31,69

111111111111111111111111111111111111
111111111111111111111111111111111111
111111111111111111111111111111111111
111111111111111111111111111111111111
111111111111111111111111111111111111
110000000000000001111111111111111111
110111111111110001111111111111111111
110100000000100011111111111111111111
110101111111110D01111111111111111111
110101111111110D01111111111111111111
110101100001110D01111111111111111111
110101101111110001111111111111111111
1101011010011100E1111111111111111111
110101101001110000111111111111111111
110101101111110000111111111111111111
110100000000010000111111111111111111
110000000000000000111111111111111111
111111111111111111111111111111111111
111111111111111111111111111111111111
111111111111111111111111111111111111
111111111111111111111111111111111111
110000000000000000111111111111111111
11111111111111111111
