SO bonus/textures/SO_WALL.xpm
WE bonus/textures/WE_WALL.xpm
EA bonus/textures/EA_WALL.xpm
NO bonus/textures/NO_WALL.xpm
C 44,43,66
F 32,31,69

11111111111111111111
11P00000000000000111
11011111111111000111
11010000000010001111
11010111111111000111
11010111111111000111
11010110000111000111
11010110111111000111
11P10110100111000111
1101P110100111000011
11010110111111000011
11010000000001000011
11000000000000000011
11E00000000000000P11
11111111111111111111
