SO bonus/textures/SO_WALL.xpm
WE bonus/textures/WE_WALL.xpm
EA bonus/textures/EA_WALL.xpm
NO bonus/textures/NO_WALL.xpm
C 44,43,66
F 32,31,69

1111111111111111111111111111111111
10000000000000000000000000000000E1
1000111111111111111111111111110011
1000100000000000000000000000000011
1000101111111111111111111111100011
1000101D00000000000000000000110011
1000101111111111111111111100011001
1000100000000000000000000011000001
1000111111111111111111111111111101
1000000000000000000000000000000001
1001111111111110111111111111111101
1001D000000000101000000000000000D1
1001111111011010111111111111111101
1000000001011010000000000000000001
1000111101011110111111111111111111
1000100000000000000000000000000001
1000101111111111111111111111111101
1000101D000000000000000000000000D1
1000111111111111111111111111111111
100000000000000000000000000000001
1111111111111111111111111111111111