SO bonus/textures/backrooms1.xpm
WE bonus/textures/backrooms.xpm
EA bonus/textures/backrooms.xpm
NO bonus/textures/backrooms1.xpm
C 0,0,0
F 165,145,75

11111111111111111111111111111111111111111111111111111111111111111111111111
10000000000000001000000000000000000000000000000000000000100000000000000001
10000000000000001000000000000000000000000000000000000000100000000000000001
10000000000000001000000000000000000000000000000000000000100000000000000001
1000000000000000111D1111111111111111111100000000000000001000000000N0000001
10000000000000000000000000000000000000001000000000000000100000000000000001
10000000000000000000000000000000000000001000000000000000100000000000000001
10000000000000000000000000000000000000001000000000000000100000000000000001
10000000000000000000000000000000000000001000000000000000111D11111111111111
10000000000000000000000000000000000000001000000000000000000000000000000001
10000000000000000000000000000000000000001000000000000000000000000000000001
10000000000000000000000000000000000000001000000000000000000000000000000001
1111111111111111111D111111111111111111111000000000000000000000000000000001
10000000000000000000000000000000000000000000000000000000000000000000000001
10000000000000000000000000000000000000000000000000000000000000000000000001
10000000000000000000000000000000000000000000000000000000000000000000000001
1000000000000000000000000000000000000000111D111111111111111111111111111111
10000000000000000000000000000000000000001000000000000000100000000000000001
10000000000000000000000000000000000000001000000000000000100000000000000001
10000000000000000000000000000000000000001000000000000000100000000000000001
11111111111111111111111111111D11111111111000000000000000100000000000000001
10000000000000001000000000000000000000001000000000000000100000000000000001
10000000000000001000000000000000000000001000000000000000100000000000000001
10000000000000001000000000000000000000001000000000000000100000000000000001
11111111111D111110000000000000000000000011111111111D1111100000000000000001
10000000000000000000000000000000000000000000000000000000000000000000000001
10000000000000000000000000000000000000000000000000000000000000000000000001
10000000000000000000000000000000000000000000000000000000000000000000000001
11111111111111111111111111111111111111111111111111111111111111111111111111