SO bonus/textures/lab_wall_dirty.xpm
WE bonus/textures/lab_wall_cracked.xpm
EA bonus/textures/lab_wall_bloody.xpm
NO bonus/textures/lab_wall_vines.xpm

C 2,155,180
F 40,38,35
111111111111
111111111111
100000000001
11111D111111
100000000001
100000N00001
100000000001
100000000001
100000000001
111111111111
111111111111