SO bonus/textures/backrooms1.xpm
WE bonus/textures/backrooms.xpm
EA bonus/textures/backrooms.xpm
NO bonus/textures/backrooms1.xpm

C 130,125,70
F 100,98,63

11111
10S01
10001
10001
10001
10001
10001
11D11
10001
10001
10001
10001
11111
