SO bonus/textures/backrooms1.xpm
WE bonus/textures/backrooms.xpm
EA bonus/textures/backrooms.xpm
NO bonus/textures/backrooms1.xpm

C 130,125,70
F 100,98,63

11111111111111111111
1000000000000000001
10S00000000000000011
1000000000000000001
10000000000000000011
1000000001D100000001
1000000000000000011
1111111111D111111111111111
100000000000000011
1000000000000000001
1000000000000000001
100000000000000001
1111111111111111111
