SO bonus/textures/mc0_wall.xpm
WE bonus/textures/mc1_wall.xpm
EA bonus/textures/mc2_wall.xpm
NO bonus/textures/mc3_wall.xpm

F 90,90,91
C 100,100,101


1111111111111111111111111
1000000000000000000000001
1011111110001111111111101
1000000010000000000000101
1001111010111111101110101
1001000010000000100010101
1001011111110111100010101
1001000000000000000010101
1011111011111111111011101
1000000010000000000000001
1111011110111111111111101
1000000000000000000000001
1011111111110111111111101
1000000000000100000000001
1000000000000000000000111
10000000N0000000000000001
1111111111111111111111111