NO textures/bloody wall.xpm
SO textures/bloody wall.xpm
WE textures/bloody wall.xpm
EA textures/bloody wall.xpm

F 0,0,0
C 100,100,100

111111111111111
100000000000001
100000000000001
100000000000001
10000000N000001
100000000000001
100000000000001
100000000000001
111111111111111
