NO textures/NO.xpm 
SO textures/SO.xpm
WE textures/WE.xpm
EA textures/EA.xpm
F 164,169,20
C 153,204,255
11111111111111111111111111111
1000000000000000000000000001
10110000111000N0001111111111
11111111110000000000000000011111
101100000111000000000111111
11111111100110000011101111111
11110111111111011100000010001
111101111111110111010100100011111111111111111
1100000011010101110000001000000000000000001011
1000000000000000000000000000000000000000000011
10000000000000001   10000001000000000000000001011
10000000000000001100000010001111111111111111
10000000000000001100010000001                 
11000000110101000000000000001
11110111110101000000000000001
10000000001100000100000010001
10000000000000000000000001001
10000000111100010000000001001
100000001  100110101110000001
10000000111110000001 10100001
11111111111111111111 111111111
