C 1,2,255
SO textures/SO.xpm
WE textures/WE.xpm
EA textures/EA.xpm
NO textures/NO.xpm
F 1,2,4





1111111111111111111111111111111111111111111111111111111
1111111111111111111111111111111111111111111111111111111
10000000001100000000000000001
1011000011100000001111111111
11111111110000000000000000011111
101100000111000000000111111

11111111100110000011101111111
11110111111111011100000010001
11110111111111011101S100100011111111111111
11000000110101011100000010001100000000001011
1000000000000000000110000000000000000001111
10000000000000000001 10000000000000000001111
1000000000000000000110000000000000000001111
10000000000000001100000010001100000000001011
1111111111111111111111111111111111111111111111111111111