C 135,206,235
SO textures/SO.xpm
WE textures/WE.xpm
EA textures/EA.xpm
NO textures/NO.xpm
F 120,100,80


11111111111111111111111111111111
10000000000000000000000000000001
10000000000000000000000000000001
10000000111111111111110000000001
10000001100000000000011000000001
10000001000000000000001000000001
10000001001111111110001000000001
10000001001000000010001000000001
10000001001011N11010001000000001
10000001001010001010001000000001
10000001001010001010001000000001
10000001001010001010001000000001
10000001001010001010001000000001
10000001001010001010001000000001
10000001001110001111001000000001
10000001000000000000001000000001
10000001100000000000011000000001
10000000111111111111110000000001
10000000000000000000000000000001
10000000000000000000000000000001
11111111111111111111111111111111
