SO textures/SO.xpm
WE textures/WE.xpm
EA textures/EA.xpm
NO textures/NO.xpm

C 1,1,155
F 1,1,4

11111111111111111111
11000000000000000111
11011111111111000111
1101000000001000111
11010111111111000111
11010111111111000111
11010110000111000111
11010110111111000111
11010110100111000111
11010110100111000011
11010110111111000011
11010000000001000011
11000000000000000011
11N00000000000000011
11111111111111111111
