SO mandatory/textures/SO.xpm
WE mandatory/textures/WE.xpm
EA mandatory/textures/EA.xpm
C 1,1,255
NO mandatory/textures/NO.xpm
F 210,90,110

1111111
100N001
1111111