SO mandatory/textures/SO.xpm
WE mandatory/textures/WE.xpm
EA mandatory/textures/EA.xpm
NO mandatory/textures/NO.xpm
C 5,2,8
F 1,90,110

1111111111
1000000001
1000100001
1000010001
100N000001
1000000001
1111111111