C 5,250,8
SO mandatory/textures/SO.xpm
WE mandatory/textures/WE.xpm
EA mandatory/textures/EA.xpm
NO mandatory/textures/NO.xpm
F 1,90,110

1111111111      1111
1111111111
1000000001
1111111111
1111111111      1111
10000001111     10N01
1111111111      1111