C 5,250,8
SO mandatory/textures/SO.xpm
WE mandatory/textures/WE.xpm
EA mandatory/textures/EA.xpm
NO mandatory/textures/NO.xpm
F  1,90,110

1111111111
1111111111
1000000001
1001001111
1010000011
10000N0111
1111111111