SO mandatory/textures/SO.xpm
WE mandatory/textures/WE.xpm
EA mandatory/textures/EA.xpm
C 1,1,255
NO mandatory/textures/NO.xpm
F 1,90,110
111111
1000001
100N001
1000001
111111